50
08
40 02 00 00 00 00 00 00 00 00 00 00 00 00 00 00 00 00 00 00 00 00 00 00 00 00 00 00 00 00 00 00 00 00 00 00 01 40 40 40 40 40 40 40 40 40 40 40 40 40
40 02 00 00 00 00 00 00 00 00 00 00 00 00 00 00 00 00 00 00 00 00 00 00 00 00 00 00 00 00 00 00 00 00 00 00 01 40 40 40 40 40 40 40 40 40 40 40 40 40
40 02 00 00 00 00 00 00 00 00 00 00 00 00 00 00 00 00 00 00 00 00 00 00 00 00 00 00 00 00 00 00 00 00 00 00 00 00 00 00 00 01 40 40 40 40 40 40 40 40
40 02 00 00 13 14 15 00 00 00 00 00 00 05 06 00 00 00 00 00 00 00 00 01 40 02 00 00 00 00 00 01 40 40 40 02 00 00 00 00 00 00 00 00 01 40 40 40 40 40
40 02 00 00 00 00 00 00 00 01 40 40 02 00 00 00 00 07 08 00 00 00 00 01 40 03 40 40 40 02 00 00 00 00 00 00 01 40 02 00 00 00 00 00 00 00 01 40 40 40
40 02 00 00 00 01 40 40 40 40 40 40 02 00 01 40 02 00 00 00 00 00 00 01 40 02 00 00 00 00 00 00 00 00 00 00 01 40 40 02 00 00 00 00 00 00 01 40 40 40
40 02 10 11 12 01 40 40 40 40 40 40 40 40 40 40 40 40 40 40 40 40 40 40 40 02 00 00 01 40 40 00 00 00 00 00 01 40 40 40 02 00 00 00 00 04 01 40 40 40
40 40 40 40 40 40 40 40 40 40 40 40 40 40 40 40 40 40 40 40 40 40 40 40 40 40 40 40 40 40 40 40 40 40 40 40 40 40 40 40 40 40 40 40 40 40 40 40 40 40