50
08
40 40 40 40 02 00 00 40 40 40 40 40 40 40 40 40 40 40 40 40 40 40 03 40 40 40 40 40 40 40 40 02 00 00 00 00 00 01 40 40 40 40 40 40 40 40 40 40 40 40
41 00 00 00 00 00 00 00 00 00 00 00 00 01 40 40 40 40 40 40 40 40 40 02 00 00 00 01 40 40 40 02 00 00 00 00 00 00 00 01 40 02 00 00 00 00 00 00 00 41
41 00 00 00 00 00 00 00 00 00 00 00 00 01 40 02 00 00 00 00 00 00 00 00 00 00 00 01 40 40 40 02 00 00 00 00 00 00 00 01 40 02 00 00 00 00 00 00 00 41   
40 40 40 40 40 02 00 00 01 40 40 40 00 01 40 02 00 00 00 00 00 00 01 40 40 40 40 02 00 00 00 00 00 00 00 00 00 00 00 01 40 40 40 40 40 40 40 40 40 40  
41 00 00 00 00 00 00 00 00 00 01 40 40 40 40 02 00 00 00 00 00 00 01 40 02 00 00 00 00 01 40 40 02 00 00 00 00 00 00 00 00 00 00 00 00 00 00 00 00 41 
41 00 00 00 00 00 00 00 00 00 00 00 00 00 00 00 00 00 00 00 00 01 40 40 02 00 00 00 00 01 40 40 40 02 00 00 00 00 00 01 40 40 40 40 40 40 40 02 00 41 
41 00 00 00 00 01 40 02 00 00 00 00 00 01 40 02 00 00 00 00 00 01 40 40 02 00 00 00 00 01 40 40 40 40 40 02 00 00 00 00 00 00 00 00 00 04 40 02 00 41
40 40 40 40 40 40 40 40 40 40 40 40 40 40 40 40 40 40 40 40 40 40 40 40 40 40 40 40 40 40 40 40 40 40 40 40 40 40 40 40 40 40 40 40 40 40 40 40 40 40 