50
08
40 40 40 40 40 40 40 40 40 40 40 40 40 40 40 40 40 40 40 40 02 00 01 40 40 40 40 40 40 40 40 40 40 40 40 40 48 49 50 51 52 40 40 40 40 40 40 40 40 40
40 02 00 00 00 00 00 01 40 40 40 40 40 40 02 00 00 00 00 00 09 10 11 12 00 00 00 01 40 02 00 00 00 00 01 40 02 00 00 00 01 40 40 40 40 40 40 40 40 40
40 02 00 00 00 00 00 00 00 00 00 01 40 40 40 40 40 40 40 02 00 00 00 00 00 00 00 01 40 02 00 00 00 00 01 40 03 40 45 46 47 40 40 40 40 40 40 02 01 40   
40 40 40 03 40 40 40 40 02 00 00 00 00 00 00 00 00 00 00 00 01 40 03 40 40 40 40 40 40 02 00 00 00 00 00 00 00 01 40 40 40 40 40 02 00 00 00 00 01 40  
40 02 00 01 40 40 40 40 02 00 00 00 00 00 00 00 00 00 00 00 01 40 03 40 02 00 00 00 00 00 00 00 00 00 00 00 00 00 00 01 40 40 40 02 05 06 07 08 01 40 
40 02 00 01 40 40 40 40 40 02 00 00 01 40 40 02 00 00 00 00 01 40 03 40 02 00 00 00 00 00 00 00 01 40 02 00 00 01 40 03 40 40 40 02 00 00 00 00 01 40 
40 02 04 01 40 40 40 40 40 02 00 00 00 00 00 00 01 40 40 02 01 40 40 40 02 00 00 00 00 00 00 00 00 00 00 00 00 01 40 02 00 00 00 01 40 40 40 40 40 40
40 40 40 40 40 40 40 40 40 40 40 40 40 02 00 00 00 00 00 01 40 40 40 40 40 40 40 40 40 40 40 02 00 00 00 00 00 01 40 40 41 42 43 44 40 40 40 40 40 40 