50
08
40 40 40 40 40 40 40 40 40 40 40 40 40 40 40 40 40 40 02 00 00 00 01 40 40 40 40 40 40 40 40 40 40 40 40 40 40 40 40 40 40 40 40 40 40 40 40 40 40 40
40 02 00 00 00 00 00 01 40 40 40 40 40 40 03 40 40 40 02 00 00 00 00 00 00 00 00 01 40 02 00 00 00 00 01 40 02 00 00 00 00 01 40 40 40 40 40 40 40 40
40 02 05 06 07 00 00 00 00 00 00 01 40 40 40 40 40 40 02 00 00 00 00 00 00 00 00 01 40 02 00 00 00 00 01 40 03 40 40 40 40 03 40 40 40 40 40 02 01 40   
40 40 40 03 40 40 40 40 02 00 00 00 00 00 00 00 00 00 00 00 01 40 03 40 40 40 40 40 40 02 00 00 00 00 00 00 00 01 40 40 40 03 40 02 00 00 00 00 01 40  
40 02 00 01 40 40 40 40 02 00 00 00 00 00 00 00 00 00 00 00 01 40 02 00 00 00 00 00 00 00 00 00 00 00 00 00 00 01 40 40 40 03 40 02 00 00 00 00 14 40 
40 02 00 01 40 40 40 40 02 00 00 00 01 40 40 02 00 00 00 00 01 40 02 00 00 00 00 00 00 00 00 00 01 40 02 00 00 01 40 40 40 03 40 02 00 00 00 00 01 40 
40 02 04 01 40 40 40 40 02 00 00 00 00 00 08 09 01 40 40 02 01 40 40 40 02 00 00 00 00 00 00 00 10 11 12 13 00 01 40 40 40 02 00 01 40 40 40 40 40 40
40 40 40 40 40 40 40 40 41 42 43 44 40 02 00 00 00 00 00 01 40 40 40 40 40 40 40 40 40 40 40 02 00 00 00 00 00 01 40 40 40 40 40 40 40 40 40 40 40 40 