25
16
40 40 40 40 40 40 40 40 40 40 40 40 40 40 40 40 40 40 40 40 40 40 40 40 40 
40 02 00 00 00 00 00 00 00 00 00 00 00 00 01 40 02 00 00 00 00 00 00 01 40
40 02 00 00 00 00 00 00 00 00 00 00 00 00 01 40 02 00 00 00 00 00 00 01 40
40 02 00 00 00 00 00 00 00 00 00 00 00 00 01 40 02 00 00 00 00 00 00 01 40
40 02 00 00 00 00 00 00 00 00 00 00 00 00 01 40 02 00 00 00 00 00 00 01 40
40 02 00 00 00 00 00 00 00 00 00 00 00 00 01 40 02 00 00 00 00 00 00 01 40
40 02 04 05 00 00 00 00 00 00 00 00 00 00 00 00 00 00 00 00 00 00 00 01 40
40 40 40 40 40 40 40 40 40 40 40 40 40 40 40 40 40 40 40 40 40 40 02 01 40 
40 40 40 40 40 40 40 40 40 40 40 40 40 40 40 40 40 40 40 40 40 02 01 40 40 
40 02 00 00 00 00 00 00 00 00 00 00 00 00 00 00 01 40 40 40 02 01 40 40 40 
40 02 00 00 00 00 00 00 00 00 00 00 00 00 00 00 00 00 00 00 01 40 40 40 40
40 02 00 00 00 00 00 00 00 00 00 00 00 00 00 00 00 00 00 01 40 40 40 40 40 
40 02 00 00 00 00 00 00 00 00 00 00 00 00 00 00 00 00 01 40 40 40 40 40 40 
40 02 00 00 00 00 00 00 00 00 00 00 00 00 00 00 00 01 40 40 40 40 40 40 40
40 02 00 00 00 00 00 00 00 00 00 00 00 00 00 00 00 00 00 00 00 00 00 01 40 
40 40 40 40 40 40 40 40 40 40 40 40 40 40 40 40 40 40 40 40 40 40 40 40 40 