20
28
40 40 40 40 40 40 40 40 40 40 40 02 00 00 00 00 41 00 00 00
40 02 00 01 40 02 00 00 01 40 40 02 00 00 00 00 41 00 00 00
40 40 40 03 40 02 00 00 01 40 40 02 00 00 00 00 41 00 00 00
40 02 00 01 40 02 00 00 01 40 40 02 00 00 00 00 41 00 00 00
40 03 40 03 40 02 00 00 01 40 40 02 00 00 00 00 41 00 00 00
40 02 01 40 40 02 00 00 00 00 40 02 00 00 00 00 41 00 00 00
40 02 00 01 40 02 01 40 40 40 40 06 06 06 06 06 41 41 41 41
40 40 02 01 40 40 02 00 01 40 40 02 00 00 00 00 00 00 00 41
40 02 01 40 40 40 02 00 01 40 40 02 00 00 00 00 00 00 00 41
40 02 00 01 40 40 40 02 01 40 40 02 00 00 00 00 00 00 00 41
40 03 40 40 40 02 00 01 40 40 40 02 00 00 00 00 00 00 00 41
40 02 00 00 00 00 00 00 01 40 40 02 00 00 00 00 00 00 00 41
40 02 00 00 00 01 40 40 40 40 40 02 00 00 00 00 00 00 00 41
40 02 00 00 00 01 40 40 40 40 40 02 00 00 00 00 00 00 00 41
40 02 00 00 00 01 40 40 40 40 40 02 00 00 00 00 00 00 00 41
40 40 02 01 40 03 40 40 40 40 40 02 00 00 00 00 00 00 00 41
40 40 40 03 40 02 00 00 01 40 40 02 00 00 00 00 00 00 00 41
40 02 00 01 40 02 00 00 01 40 40 02 00 00 00 00 00 00 00 41
40 03 40 40 40 40 40 40 40 40 40 02 00 00 00 00 00 00 00 41
40 02 00 00 00 00 00 00 01 40 40 02 00 00 00 00 00 00 00 41
40 02 00 00 00 00 00 00 01 40 40 02 00 00 00 00 00 00 00 41
40 02 00 00 00 00 00 00 01 40 40 02 00 00 00 00 00 00 00 41
40 02 00 00 01 40 40 40 03 40 40 02 00 00 00 00 00 00 00 41
40 40 02 00 01 40 02 00 01 40 40 02 00 00 00 00 00 00 00 41
40 02 00 00 01 40 02 00 01 40 40 02 00 00 00 00 00 00 00 41
40 02 00 01 40 40 02 00 01 40 40 02 00 00 00 00 00 00 00 41
40 02 00 00 01 40 02 00 01 40 40 02 00 00 00 00 00 00 00 00
40 40 40 40 40 40 40 40 40 40 40 40 40 40 40 40 40 40 40 40